-------##########################
----------------------#---------#
----------------------#---------#
#-----G-----T---P---------------#
#---------W---G-----------------#
#---------WW----------#---------#
#----------WW---------#---------#
#-----------ggggg-----#---------#
#---------------------#---------#
#---------------------#---------#
#--------K------------#---------#
#---------------------#---------#
#---------------------#---------#
#################################